15
12
(1, 11) (1,9) (12,9) (12,7) (4,7) (4,1) (7,1) (7,4) (9,4) (9,1) (14,1)
0 0 0 0 0 0 0 0 0 0 0 0 0 0 0 
0 0 0 0 1 1 1 1 0 1 1 1 1 1 3 
0 0 0 0 1 0 0 1 0 1 0 0 0 0 0 
0 0 0 0 1 0 0 1 0 1 0 0 0 0 0 
0 0 0 0 1 0 0 1 1 1 0 0 0 0 0 
0 0 0 0 1 0 0 0 0 0 0 0 0 0 0 
0 0 0 0 1 0 0 0 0 0 0 0 0 0 0 
0 0 0 0 1 1 1 1 1 1 1 1 1 0 0 
0 0 0 0 0 0 0 0 0 0 0 0 1 0 0 
0 1 1 1 1 1 1 1 1 1 1 1 1 0 0 
0 1 0 0 0 0 0 0 0 0 0 0 0 0 0 
0 2 0 0 0 0 0 0 0 0 0 0 0 0 0 
